1111111111111111111111
1010001011100110101111
1010101100000100011011
1000000P000000000F1111
1011101000000010001011
1100011011101000001011
1000000000000010000011
1010101000000000001011
1110000010000010000001
1000C00C000000000000E1
1111111111111111111111