111111
100001
1FCPE1
100001
111111