111111111111111111111111111111111111111111111111111111111111111111111111111111111
101000101110111010000000000000000000000000000000000000000000000000000000000001111
101010111111111111100000000000000000000000000000000000000000000000000000000000011
1000000P0000000000000000000000000000000000000000000000000000000000000000000001111
101110101111100000000000000000000000000000000000000000000000000000000000000000011
111111101110101000100000000000000000000000000000000000000000000000000000000000011
100011101111101011100000000000000000000000000000000000000000000000000000000000011
101010101111111010000000000000000000000000000000000000000000000000000000000001011
111011101000101010000000000000000000000000000000000000000000000000000000000000011
1000C00C10101000000000000000000000000000000000000000000000000000000000000000000E1
111111111111111111111111111111111111111111111111111111111111111111111111111111111